#import std
#next
#perfect 93
#define hh:hk,ds<hk
wa wa wa wa wa wa --
-- -- cy hk bx hh 1h
-- -- -- -- wa -- 1x
wa wa -- -- -- -- --
wa wa wa -- -- -- --