#next 9-1
#perfect 52
wa    wa wa -- wa wa wa       wa
cv<rt cy wk bx ic sp ds<wk    wa
wa    -- ic ic -- -- ic,ds<bb wa
wa    -- bb ic ic ic ic,ds<bx ic
wa    -- bx ic ic bx --       --
wa    -- ic -- ic ic ic       bx
wa    wa wa wa wa wa --       --