#next
#perfect 26
cy    ds<bx -- -- wa
wa    bx    bx wa wa
ds<bx --    bx -- wa
bx    --    -- -- wa
ds<bx --    -- wa wa
wa    wa    wa wa wa