#next
#perfect 29
-- -- cy bx    ds<bx wa
-- -- -- ds<bb ds<bx wa
wa -- wa bx    --    --
wa -- bb --    --    --
wa wa wa wa    --    --
wa wa wa wa    wa    wa
tx<C2\:bluebox