#next
#perfect 31
wa wa -- wa       wa
cy cy -- bx,ds<bb ds<bb
wa -- bb --       --
wa bb -- --       --
wa -- -- wa       wa
wa wa wa wa       wa
tx<C3\:multi-cyan