#next
#perfect 28
-- --       wa ds<bx wa
-- bx,ds<bb sp --    --
-- --       -- --    wa
-- cy       wa bb    wa
wa --       wa --    cy
wa wa       wa --    wa
wa wa       wa wa    wa
_tx_