#import std
#next
#perfect 30
wa wa 1x wa wa wa
-- cy -- -- -- --
-- 3r -- -- bx --
-- -- -- bx -- 3l
wa wa -- -- bx --
wa wa -- -- -- wa
fill
_tx_