#next
#perfect 27
cy -- -- bx wp    wa -- -- -- --
gw wa -- wa wa    wa -- -- -- --
-- -- -- wa wa    wa -- -- -- --
-- -- wp -- ds<wp wa -- -- -- --
wa wa wa wa wa    wa -- -- -- --
_tx_