#next 8-1
#perfect 56
cy    bx bx --     ds<bb wa
--    -- wa --     wa    wa
--    gw -- --     wa    wa
--    -- wp bb     gw    --
wa    wa wa ds<bx  wa    wa