#next
#perfect 21
wa --    wa wa wa
wa cy    -- gw --
wa wp    wa wa --
-- gw    bx -- --
wa cr    wa wa wa
wa ds<bx wa wa wa
_tx_