#name 1982
#import std
#perfect 10
-- -- wa wa wa -- -- --
-- -- wa 1x wa -- -- --
-- -- wa -- wa wa wa wa
wa wa wa bx -- bx 1x wa
wa 1x -- bx cy wa wa wa
wa wa wa wa bx wa -- --
-- -- -- wa 1x wa -- --
-- -- -- wa wa wa -- --