#next
#perfect 41
--    -- wa wa wa -- --
bx    -- -- -- wa -- --
bx,sp -- bx -- wa -- --
cy    sp -- wa wa -- --
bb    -- -- wa wa -- --
sp    -- bx wa wa -- --
--    -- -- wa wa -- --
ds<bb wa wa wa wa -- --
tx<Tips:You_can_still_win_even_if_you_died