#next
#perfect 11
-- -- ds<bx wa    wa
cy bb sp    ds<bb wa
cy -- --    --    wa
-- bx --    wa    wa
wa -- --    wa    wa