#next
#perfect 19
sp sp sp sp ds<bx sp sp
sp cy ic ic --    ic sp
sp ic -- -- ic    ic sp
sp sp ic bx ic    ic sp
sp -- -- ic ic    ic sp
sp -- ic -- --    ic sp
sp sp sp -- --    sp sp
wa wa wa wa wa    wa wa
_tx_