#next
#perfect 21
cy wa ic ic ic wa    wa
ic ic bx ic ic wa    wa
-- ic ic ic ic ds<bx wa
ic bx bx ic ic wa    wa
ic -- -- ic ic wa    wa
wa wa wa wa wa wa    wa