#next
#perfect 27
cy    ic    cy ic wa
ds<bb bx    ic -- --
ic    ic    ic bb wa
ic    ds<bx -- ic --
wa    --    wa wa wa