#next
#perfect 118
wa wa wa 1x wa wa wa wa
-- -- -- -- -- bb -- cy
-- bx sp bb -- -- -- wa
1b -- -- wa -- -- cy --
wa -- wa -- wa -- -- --
wa -- bx bx -- wa -- --
-- cy -- -- -- -- wa --
-- -- -- -- -- 1b wa 1x
fill
tx<Three!_Three_of_them!
tx<\(WARNING:EXTREMELY_TEDIOUS\)