#next
#perfect 57
-- wa -- -- wa -- -- --
-- -- wa wa -- bx wk --
-- -- -- cy -- 2l bx 1x
1k -- bx -- -- 2d -- --
-- bb wa -- 2r -- -- --
-- -- -- wa -- -- -- 1b
fill
tx<Now_conveyors_add_to_the_level!
tx<Also_weakboxes