#next
#perfect 140
wa -- 1b -- -- -- 1x
-- cy wa -- wa wa --
-- -- bb -- bx -- --
wa wa gw -- -- wa --
-- -- -- -- -- 1x wp
-- gw wa wa -- wa --
-- -- bb -- -- bx 1b
fill
tx<Greenwarp_has_come!
tx<\(TEDIOUS_WARNING\)