#import std
#next
#perfect 42
#define ca:cy,ad<cy
wa wa wa cy wa wa wa
wa wa wa -- bb -- --
ca wa wa 2r -- wa --
1x -- bx -- -- -- --
1b wa wa wa wa wa wa