#next
#perfect 106
#import std
wa wa 1l wa wa -- -- -- wa
-- -- cy ky -- ky wa -- wa
-- -- -- 2r -- lk -- -- --
wa wa -- wa lk wa wa bx --
wa wa 1x -- -- -- 2l 1y --