#import std
#next
#perfect 75
cy bx wp -- 1x 1b --
-- -- wa -- wa wa --
-- bb bb -- -- -- --
-- wa wa -- wa wa wp
-- -- wp bx bb -- bx
1x bb -- bx -- -- --
fill
_tx_