#import std
#next
#perfect 14
ic ic ic ic ic ic ic ic ic
ic 3x ic ic ic ic wa ic ic
ic ic cy ic ic ic wa ic ic
ic ic ic ic ic 3b ic ic ic
ic ic ic 3x ic ic ic ic ic
ic ic ic ic ic ic 3x bb ic
ic ic ic ic ic ic ic ic 3x
1x ic -- ic ic ic ic ic ic
ic ic ic 3x bb ic ic ic wa