#next
#perfect 93
wa 1x wa -- -- -- -- gw
wa 1b -- -- wp -- 1x --
wa 1f wa wa -- -- -- --
-- sw -- wa wa wa wa wa
-- -- -- -- -- -- -- --
-- lf lf -- gw bb -- --
-- wa -- -- wa -- bx --
cy bx -- -- wa -- -- --