#next 10-1
#perfect 75
wa cy    lf ic,ds<bx --
wa ds<lf wa bx       sw
-- gw    wp --       --
-- --    -- gw       wa
sw --    wa wa       wa