#next
#perfect 21
wa       wa wa -- wa
ds<bb,cy -- -- -- wa
wa       -- wa bx wa
--       bb wa -- wa
--       bx bx -- --
--       -- bx -- --