#next
#perfect 15
cy wa    wa    -- wa
-- bx    --    cy --
-- --    cv<lt bb --
wa --    wa    -- wa
wa sp    wa    sp wa
wa ds<bb wa    ds<bx wa