#next
#perfect 12
wa cy wa -- -- wa    --
wa -- -- -- -- wa    wa
wa -- wa wa wa ds<cy --
wa -- -- -- -- wa    --
wa -- wa -- -- --    --
wa -- -- wa wa wa    wa
wa wa -- -- -- --    --