#next
#perfect 14
cy -- wa wa -- wa ds<cy wa
-- bx -- bx bx -- --    --
-- bx -- wa -- wa wa    wa
wa -- wa wa -- wa wa    wa
-- -- -- -- -- wa wa    wa
wa wa wa wa wa wa wa    wa
_tx_