#next
#perfect 20
cy    wa wa wa wa wa
--    -- -- wa -- --
wa    wa -- -- bx --
wa    wa -- wa bx --
wa    wa -- bx -- --
ds<bx -- -- -- -- wa