#next
#perfect 9
wa cy wa cy -- --    wa
-- -- wa wa -- --    wa
-- sp wa wa bx --    wa
-- -- wa sp sp --    wa
wa -- bx sp -- ds<bx wa
wa wa wa wa wa wa    wa
tx<You_can_control_multiple_players