#next
#perfect 7
wa sp wa    ds<bx wa -- --
wa -- --    sp    wa -- --
cy bx bx    cy    wa -- --
wa wa sp    --    wa -- --
wa wa ds<bx wa    wa -- --
_tx_