#next
#perfect 12
-- cy cv<dw ds<bx cv<lt --
wa -- bb    sp    sp    wa
wa -- bx    sp    --    wa
wa cy --    --    --    wa
wa wa wa    --    wa    wa
wa wa wa    wa    wa    wa
tx<C4\:conveyor