#next
#perfect 34
wa -- -- wa wa       wa
wa -- -- cy wa       wa
wa cy wk -- cv<dw    --
-- -- -- wa bx       bx
wa -- -- -- ds<bx    ds<bx
wa -- bb -- bb,ds<wk --
wa wa -- -- wa       --
wa wa wa wa wa       wa
tx<C4:weakbox